 9, 9, 9, 9, 9, 9, 9, 9, 9, 9, 9, 9, 9, 9, 9, 9, 9, 9, 9, 9, 9, 9, 9, 9, 9, 9, 9, 9, 9, 9, 9, 9, 9, 9, 9, 9, 9, 9, 9, 9,
 9, 9, 9, 9, 9, 9, 9, 9, 9, 9, 9, 9, 9, 9, 9, 9, 9, 9, 9, 9, 9, 9, 9, 9, 9, 9, 9, 9, 9, 9, 9, 9, 9, 9, 9, 9, 9, 9, 9, 9,
 9, 9, 9, 9, 9, 9, 9, 9, 9, 9, 9, 9, 9, 9, 9, 9, 9, 9, 9, 9, 9, 9, 9, 9, 9, 9, 9, 9, 9, 9, 9, 9, 9, 9, 9, 9, 9, 9, 9, 9,
 9, 9, 9, 9, 9, 9, 9, 9, 9, 9, 9, 9, 9, 9, 9, 9, 9, 9, 9, 9, 9, 9, 9, 9, 9, 9, 9, 9, 9, 9, 9, 9, 9, 9, 9, 9, 9, 9, 9, 9,
 9, 9, 9, 9,52,53,52,53,52,53,51,68,69,52,53,52,53,67,51,68,69,68,69,68,69,51,51,51,52,53,51,68,69,51,68,69, 9, 9, 9, 9,
 9, 9, 9, 9,51,10,10,10,10,10,10,84,85,51,52,53,51,83,51,84,85,84,85,84,85,68,69,52,53,52,53,84,85,51,84,85, 9, 9, 9, 9,
 9, 9, 9, 9,67,10,10,10,10,10,10,51,10,10,10,10,10,10,10,10, 7, 7,10,10,10,84,85,10,10,10,10,10,10,10,10,51, 9, 9, 9, 9,
 9, 9, 9, 9,83,10,10,10,10,10,10,51,10,10,10,10,10,10,10,10,22,24,10,10,10,10,10,10,10,10,10,10,10,10,10,67, 9, 9, 9, 9,
 9, 9, 9, 9,67,10,10,10,10,10,10,51,10,10,10,10,10,10,10,10,38,40,10,10,10,10,10,10,10,10,10,10,10,10,10,83, 9, 9, 9, 9,
 9, 9, 9, 9,83,10,10,10,10,10,10,68,69,51,52,53,51,68,69,52,53,52,53,52,53,52,53,52,53,67,97,98,10,10,10,67, 9, 9, 9, 9,
 9, 9, 9, 9,67,10,10,10,10,10,10,84,85,52,53,52,53,84,85,51,52,53,52,53,51,68,69,10,10,83,10,10,10,10,10,83, 9, 9, 9, 9,
 9, 9, 9, 9,83,97,97,98,10,10,10,51,52,53,52,53,52,53,51,52,53,52,53,52,53,84,85,10,10,67,10,10,10,10,10,67, 9, 9, 9, 9,
 9, 9, 9, 9,67,10,10,10,10,10,10,10,10,10,10,10,10,10,10,10,10,10,10,10,10,10,67,97,97,83,97,98,10,10,10,83, 9, 9, 9, 9,
 9, 9, 9, 9,83,10,10,10,10,10,10,10,10,10,10,10,10,10,10,10,10,10,10,10,10,10,83,10,10,67,10,10,10,10,10,67, 9, 9, 9, 9,
 9, 9, 9, 9,67,10,10,10,10,10,10,10,10,10,10,10,10,10,10,10,10,10,10,10,10,10,67,10,10,83,10,10,10,10,10,83, 9, 9, 9, 9,
 9, 9, 9, 9,83,97,97,97,97,97,98,10,10,10,10,10,10,10,10,10,10,10,10,10,10,10,83,51,51,51,97,98,10,10,10,67, 9, 9, 9, 9,
 9, 9, 9, 9,67,10,10,10,10,10,10,10,10,10,10,10,10,10,10,10,10,10,10,10,10,10,10,10,10,10,10,10,10,10,10,83, 9, 9, 9, 9,
 9, 9, 9, 9,83,10,10,10,10,10,10,10,10,10,10,10,10,10,10,10,10,10,10,10,10,10,10,10,10,10,10,10,10,10,10,67, 9, 9, 9, 9,
 9, 9, 9, 9,51,97,97,97,97,97,98,10,10,10,10,10,10,10,10,96,97,97,97,97,97,97,97,97,97,97,97,97,97,97,97,83, 9, 9, 9, 9,
 9, 9, 9, 9,67,10,10,10,10,10,10,10,10,10,10,10,10,10,10,10,10,10,10,10,10,10,10,10,10,10,10,10,10,10,10,51, 9, 9, 9, 9,
 9, 9, 9, 9,83,10,10,10,10,10,10,10,10,10,10,10,10,10,10,10,10,10,10,10,10,10,10,10,10,10,10,10,10,10,10,51, 9, 9, 9, 9,
 9, 9, 9, 9,67,52,53,52,53,52,53,52,53,52,53,51,68,69,10,10,10,10,10,10,10,10,10,10,10,10,10,10,10,10,10,67, 9, 9, 9, 9,
 9, 9, 9, 9,83,10,10,10,10,10,10,10,10,10,10,10,84,85,97,97,97,97,97,97,97,97,97,97,97,97,97,97,97,97,97,83, 9, 9, 9, 9,
 9, 9, 9, 9,67,10,10,10,10,10,10,10,10,10,10,10,10,10,10,10,10,10,10,10,10,10,10,10,10,10,10,10,10,10,10,51, 9, 9, 9, 9,
 9, 9, 9, 9,83,10,10,10,10,10,10,10,10,10,10,10,10,10,10,10,10,10,10,10,10,10,10,10,10,10,10,10,10,10,10,51, 9, 9, 9, 9,
 9, 9, 9, 9,51,68,69,52,53,52,53,51,68,69,52,53,52,53,52,53,68,69,52,53,52,53,52,53,68,69,52,53,52,53,68,69, 9, 9, 9, 9,
 9, 9, 9, 9,51,84,85,51,52,53,52,53,84,85,51,52,53,52,53,51,84,85,51,52,53,52,53,51,84,85,51,52,53,51,84,85, 9, 9, 9, 9,
 9, 9, 9, 9, 9, 9, 9, 9, 9, 9, 9, 9, 9, 9, 9, 9, 9, 9, 9, 9, 9, 9, 9, 9, 9, 9, 9, 9, 9, 9, 9, 9, 9, 9, 9, 9, 9, 9, 9, 9,
 9, 9, 9, 9, 9, 9, 9, 9, 9, 9, 9, 9, 9, 9, 9, 9, 9, 9, 9, 9, 9, 9, 9, 9, 9, 9, 9, 9, 9, 9, 9, 9, 9, 9, 9, 9, 9, 9, 9, 9,
 9, 9, 9, 9, 9, 9, 9, 9, 9, 9, 9, 9, 9, 9, 9, 9, 9, 9, 9, 9, 9, 9, 9, 9, 9, 9, 9, 9, 9, 9, 9, 9, 9, 9, 9, 9, 9, 9, 9, 9,
 9, 9, 9, 9, 9, 9, 9, 9, 9, 9, 9, 9, 9, 9, 9, 9, 9, 9, 9, 9, 9, 9, 9, 9, 9, 9, 9, 9, 9, 9, 9, 9, 9, 9, 9, 9, 9, 9, 9, 9,
 9, 9, 9, 9, 9, 9, 9, 9, 9, 9, 9, 9, 9, 9, 9, 9, 9, 9, 9, 9, 9, 9, 9, 9, 9, 9, 9, 9, 9, 9, 9, 9, 9, 9, 9, 9, 9, 9, 9, 9,
